敌草草草草草敌草草草草草敌
草草空铁砖铁空铁砖铁空草草
草草空砖空砖空砖空砖空草草
草草空铁砖铁空铁空铁空草草
草空空空空砖空砖空砖空草草
草草空铁砖铁空铁砖铁空草草
草草草草草水水水草草草草草
铁空空铁空空铁空空铁空空铁
草空空空空砖砖砖空空空空草
草砖铁砖铁水水水铁砖铁砖草
草砖空砖空空空空空砖空砖草
草砖空砖空留留留空砖空砖草
草草草空空留堡留空主草草空